. . . . . . . . . . . . . . . . . . . . . . . . . . . . . . . . . . . . . . . . . . . . . . . . . . . . . . . . . . . . . . . . . . . . . . . . . . . . . . . . . . . . . . . . . . . . . . . . . . . . 
. . . . . . . . . . . . . . . . . . . . . . . . . . . . . . . . . . . . . . . . . . . . . . . . . . . . . . . . . . . . . . . . . . . . . . . . . . . . . . . . . . . . . . . . . . . . . . . . . . . . 
. . . . . . . . . . . . . . . . . . . . . . . . . . . . . . . . . . . . . . . . . . . . . . . . . . . . . . . . . . . . . . . . . . . . . . . . . . . . . . . . . . . . . . . . . . . . . . . . . . . . 
. . . . . . . . . . . . . . . . . . . . . . . . . . . . . . . . . . . . . . . . . . . . . . . . . . . . . . . . . . . . . . . . . . . . . . . . . . . . . . . . . . . . . . . . . . . . . . . . . . . . 
. . . . . . . . . . . . . . . . . . . . . . . . . . . . . . . . . . . . . . . . . . . . . . . . . . . . . . . . . . . . . . . . . . . . . . . . . . . . . . . . . . . . . . . . . . . . . . . . . . . . 
. . . . . . . . . . . . . . . . . . . . . . . . . . . . . . . . . . . . . . . . . . . . . . . . . . . . . . . . . . . . . . . . . . . . . . . . . . . . . . . . . . . . . . . . . . . . . . . . . . . . 
. . . . . . . . . . . . . . . . . . . . . . . . . . . . . . . . . . . . . . . . . . . . . . . . . . . . . . . . . . . . . . . . . . . . . . . . . . . . . . . . . . . . . . . . . . . . . . . . . . . . 
. . . . . . . . . . . . . . . . . . . . . . . . . . . . . . . . . . . . . . . . . . . . . . . . . . . . . . . . . . . . . . . . . . . . . . . . . . . . . . . . . . . . . . . . . . . . . . . . . . . . 
. . . . . . . . . . . . . . . . . . . . . . . . . . . . . . . . . . . . . . . . . . . . . . . . . . . . . . . . . . . . . . . . . . . . . . . . . . . . . . . . . . . . . . . . . . . . . . . . . . . . 
. . . . . . . . # . . . # . . . . . . . . . . . . . . . . . . . . . . . . . . . . . . . . . . . . . . . . . . . . . . . . . . . . . . . . . . . . . . . . . . . . . . . . . . . . . . . . . . . . . . . 
. . . . . . . . . . . . . . . . . . . . . . . . . . . . . . . # # # # # # # # # # # # # # # # # # # # # # # # # # . . . . . . . . . . . . . . . . . . . . . . . . . . . . . . . . . . . . . . . . . . . 
. . . . . . . . # . # # # # # # # # # # # # # # # # # # # # # # # # # # # # # # # # # # # # # # # # # # # # # # # # # # # # . . . . . . . . . . . . . . . . . . . . . . . . . . . . . . . . . . . . . . 
. . . . . . . . . . . . . . . . . . . . . . . . . . . . . . . . . . . . . . . . . . . . . . . . . . . . . . . . . . # # . # # # # . . . . . . . . . . . . . . . . . . . . . . . . . . . . . . . . . . . 
. . . . . . . . . . . . . . # # # # # # # # # # # # # # # # # # # # # # # # # # # # # # # # # # # # # # # # # # # # # # # # . . # # . . . . . . . . . . . . . . . . . . . . . . . . . . . . . . . . . . 
. . . . . . . . . # # # . . . . . . . . . . . . . . . . . . . # # # # # # # # # # # # # # # # # # # # # # # . . . . . . # # # # . # . . . . . . . . . . . . . . . . . . . . . . . . . . . . . . . . . . 
. . . . . . . . . . # # # # # # # # # # # # # # # # # # # # # # . . . . . . . . . . . . . . . . . . . . # # # # # # # . # # . # # . # . . . . . . . . . . . . . . . . . . . . . . . . . . . . . . . . . 
. . . . . . . . . . . . . . . . . . . . . . . . . . . . . . . . . . . . . . . . . . . . . . . . . . . . . . . . . . # # . # . . # # # # . . . . . . . . . . . . . . . . . . . . . . . . . . . . . . . . 
. . . . . . . . . . . . . . . . . . . . . . . . . . . . . . . . . . . . . . . . . . . . . . . . . . . . . . . . . . . # # # . . . # # # . . . . . . . . . . . . . . . . . . . . . . . . . . . . . . . . 
. . . . . . . . . . . . . . . . . . . . . . . . . . . . . . . . . . . . . . . . . . . . . . . . . . . . . . . . . . . . # # . . . # # # . . . . . . . . . . . . . . . . . . . . . . . . . . . . . . . . 
. . . . . . . . . . . . . . . . # # # # # # # # # # # # # # # # # # # # # # # # . . . . . . . . . . . . . . . . . . . . . # . . . . # # . . . . . . . . . . . . . . . . . . . . . . . . . . . . . . . . 
. . . . . . . . . . . . . . # # # . . # # # . . . . . . . . . . . # # # . . . # # . . . . . . . . . . . . . . . . . . . . # # . . . # # . . . . . . . . . . . . . . . . . . . . . . . . . . . . . . . . 
. . . . . . . . . . . . . # # . . . # # . . . . . . . . . . . . . . . # # . . . # # . . . . . . . . . . . . . . . . . . . . # . . . # . # . . . . . . . . . . . . . . . . . . . . . . . . . . . . . . . 
. . . . . . . . . . . . # # . # # # # # # # # # # # # # # # # # # # # # # # . . . # # . . . . . . . . . . . . . . . . . . # # # . . # . # . . . . . . . . . . . . . . . . . . . . . . . . . . . . . . . 
. . . . . . . . . . . . # . # # . # . . . # # # # # # . . . . . . # # # # # # # . . # # . . . . . . . . . . . . . . . . . # # # . . # # # . . . . . . . . . . . . . . . . . . . . . . . . . . . . . . . 
. . . . . . . . . . . . # # # . # # . . # # . . . . . . . . . . . . . # . # . . # . . # . . . . . . . . . . . . . . . . . . # # # . . # # # . . . . . . . . . . . . . . . . . . . . . . . . . . . . . . 
. . . . . . . . . . . . # # . . # . . # # . . . . . . . . . . . . . . # # # . . . # . # . . . . . . . . . . . . . . . . . . # # # # # # # . # # . . . . . . . . . . . . . . . . . . . . . . . . . . . . 
. . . . . . . . . . . . # . . . # . # # . . . . . . . . . . . . . . . . # # . . . . # # . . . . . . . . . . . . . . . . . . . # . . # # # # # # # # # # # # # # # . . . . . . . . . . . . . . . . . . . 
. . . . . . . . . . . . # . . . # # # . . . . . . . . . . . . . . . . . . # . . . . # # . . . . . . . . . . . . . . . . . . . # # . . . . # # . . . . # # # . . # # # . . . . . . . . . . . . . . . . . 
. . . . . . . . . . . . # . . . # # . . . . . . . . . . . . . . . . . . . # . . . . . # . . . . . . . . . . . . . . . . . . . # # # # . . . # # . . . . . # # . . . # # . . . . . . . . . . . . . . . . 
. . . . . . . . . . . . # . . . # # . . . . . . . . . . . . . . . . . . . # . . . . . # . . . . . . . . . . . . . . . . . . . . . . # # # # # # # # # # # # # # # # . # # . . . . . . . . . . . . . . . 
. . . . . . . . . . . . # . . . # # . . . . . . . . . . . . . . . . . . . # . . . . . # . . . . . . . . . . . . . . . . . . . . . . . . . . # . . . # # # . . # # # # . # . . . . . . . . . . . . . . . 
. . . . . . . . . . . . # . . . # # . . . . . . . . . . . . . . . . . . . # . . . . . # . . . . . . . . . . . . . . . . . . . . . . . . . . . . . . . . # # # # . . # # # # . . . . . . . . . . . . . . 
. . . . . . . . . . . . # . . . # . . . . . . . . . . . . . . . . . . . . # . . . . . # . . . . . . . . . . . . . . . . . . . . . . . . . . . . . . . . . . # # . . . # # # . . . . . . . . . . . . . . 
. . . . . . . . . . . . # . . . # . . . . . . . . . . . . . . . . . . . . # . . . . . # . . . . . . . . . . . . . . . . . . . . . . . . . . . . . . . . . . . # # . . . # # . . . . . . . . . . . . . . 
. . . . . . . . . . . . # . . . # . . . . . . . . . . . . . . . . . . . . # . . . . . # . . . . . . . . . . . . . . . . . . . . . . . . . . . . . . . . . . . # # . . . . # . . . . . . . . . . . . . . 
. . . . . . . . . . . . # . . . # . . . . . . . . . . . . . . . . . . . . # . . . . . # . . . . . . . . . . . . . . . . . . . . . . . . . . . . . . . . . . . # # . . . . # . . . . . . . . . . . . . . 
. . . . . . . . . . . . # . . . # . . . . . . . . . . . . . . . . . . . . # . . . . . # . . . . . . . . . . . . . . . . . . . . . . . . . . . . . . . . . . . # # . . . . # . . . . . . . . . . . . . . 
. . . . . . . . . . . . # . . . # . . . . . . . . . . . . . . . . . . . . # . . . . . # . . . . . . . . . . . . . . . . . . . . . . . . . . . . . . . . . . . # # . . . . # . . . . . . . . . . . . . . 
. . . . . . . . . . . . # . . . # . . . . . . . . . . . . . . . . . . . . # . . . . . # . . . . . . . . . . . . . . . . . . . . . . . . . . . . . . . . . . . # # . . . . # . . . . . . . . . . . . . . 
. . . . . . . . . . . . # . . . # . . . . . . . . . . . . . . . . . . . . # . . . . . # . . . . . . . . . . . . . . . . . . . . . . . . . . . . . . . . . . . # # . . . . # . . . . . . . . . . . . . . 
. . . . . . . . . . . . # . . . # . . . . . . . . . . . . . . . . . . . . # . . . . . # . . . . . . . . . . . . . . . . . . . . . . . . . . . . . . . . . . . # # . . . . # . . . . . . . . . . . . . . 
. . . . . . . . . . . . # . . . # . . . . . . . . . . . . . . . . . . . . # . . . . . # . . . . . . . . . . . . . . . . . . . . . . . . . . . . . . . . . . . . # . . . . # . . . . . . . . . . . . . . 
. . . . . . . . . . . . # . . . # . . . . . . . . . . . . . . . . . . . . # . . . . . # . . . . . . . . . . . . . . . . . . . . . . . . . . . . . . . . . . . . # . . . . # . . . . . . . . . . . . . . 
. . . . . . . . . . . . # . . . # . . . . . . . . . . . . . . . . . . . . # . . . . . # . . . . . . . . . . . . . . . . . . . . . . . . . . . . . . . . . . . # # . . . . # . . . . . . . . . . . . . . 
. . . . . . . . . . . . # . . . # . . . . . . . . . . . . . . . . . . . . # . . . . . # . . . . . . . . . . . . . . . . . . . . . . . . . . . . . . . . . . . # # . . . . # . . . . . . . . . . . . . . 
. . . . . . . . . . . . # . . . # . . . . . . . . . . . . . . . . . . . . # . . . . # # . . . . . . . . . . . . . . . . . . . . . . . . . . . . . . . . . . . # # . . . . # . . . . . . . . . . . . . . 
. . . . . . . . . . . . # . . . # . . . . . . . . . . . . . . . . . . . . # . . . . # # . . . . . . . . . . . . . . . . . . . . . . . . . . . . . . . . . . . # # . . . . # . . . . . . . . . . . . . . 
. . . . . . . . . . . . # . . . # . . . . . . . . . . . . . . . . . . . . # . . . . # # . . . . . . . . . . . . . . . . . . . . . . . . . . . . . . . . . . . # # . . . . # . . . . . . . . . . . . . . 
. . . . . . . . . . . . # . . . # . . . . . . . . . . . . . . . . . . . . # . . . . # # . . . . . . . . . . . . . . . . . . . . . . . . . . . . . . . . . . . # # . . . . # . . . . . . . . . . . . . . 
. . . . . . . . . . . . # . . . # . . . . . . . . . . . . . . . . . . . . # . . . . # # . . . . . . . . . . . . . . . . . . . . . . . . . . . . . . . . . . . . # . . . . # . . . . . . . . . . . . . . 
. . . . . . . . . . . . # . . . # . . . . . . . . . . . . . . . . . . . . # . . . . # # . . . . . . . . . . . . . . . . . . . . . . . . . . . . . . . . . . . . # . . . . # . . . . . . . . . . . . . . 
. . . . . . . . . . . . # . . . # . . . . . . . . . . . . . . . . . . . . # . . . . # # . . . . . . . . . . . . . . . . . . . . . . . . . . . . . . . . . . . . # . . . . # . . . . . . . . . . . . . . 
. . . . . . . . . . . . # . . . # . . . . . . . . . . . . . . . . . . . . # . . . . # # . . . . . . . . . . . . . . . . . . . . . . . . . . . . . . . . . . . . # . . . . # . . . . . . . . . . . . . . 
. . . . . . . . . . . . # . . . # . . . . . . . . . . . . . . . . . . . . # . . . . # # . . . . . . . . . . . . . . . . . . . . . . . . . . . . . . . . . . . . # . . . . # . . . . . . . . . . . . . . 
. . . . . . . . . . . . # . . . # . . . . . . . . . . . . . . . . . . . . # . . . . # # . . . . . . . . . . . . . . . . . . . . . . . . . . . . . . . . . . . . # . . . . # . . . . . . . . . . . . . . 
. . . . . . . . . . . . # . . . # . . . . . . . . . . . . . . . . . . . . # . . . . # # . . . . . . . . . . . . . . . . . . . . . . . . . . . . . . . . . . . . # . . . . # . . . . . . . . . . . . . . 
. . . . . . . . . . . . # . . . # . . . . . . . . . . . . . . . . . . . . # . . . . # # . . . . . . . . . . . . . . . . . . . . . . . . . . . . . . . . . . . . # . . . . # . . . . . . . . . . . . . . 
. . . . . . . . . . . . # . . . # . . . . . . . . . . . . . . . . . . . . # . . . . # # . . . . . . . . . . . . . . . . . . . . . . . . . . . . . . . . . . . . # . . . . # . . . . . . . . . . . . . . 
. . . . . . . . . . . . # . . . # . . . . . . . . . . . . . . . . . . . . # . . . . # # . . . . . . . . . . . . . . . . . . . . . . . . . . . . . . . . . . . . # . . . . # . . . . . . . . . . . . . . 
. . . . . . . . . . . . # . . . # . . . . . . . . . . . . . . . . . . . . # # . . . # # . . . . . . . . . . . . . . . . . . . . . . . . . . . . . . . . . . . . # . . . . # . . . . . . . . . . . . . . 
. . . . . . . . . . . . # . . . # . . . . . . . . . . . . . . . . . . . . # # . . . # # . . . . . . . . . . . . . . . . . . . . . . . . . . . . . . . . . . . # # . . . # # . . . . . . . . . . . . . . 
. . . . . . . . . . . . # . . . # . . . . . . . . . . . . . . . . . . . . # # . . . # # . . . . . . . . . . . . . . . . . . . . . . . . . . . . . . . . . . . # # . . . # # . . . . . . . . . . . . . . 
. . . . . . . . . . . . # . . . # . . . . . . . . . . . . . . . . . . . . # . # . . # # # . . . . . . . . . . . . . . . . . . . . . . . . . . . . . . . . . # # # . . # # # . . . . . . . . . . . . . . 
. . . . . . . . . . . . # . . . # . # . . . . . . . . . . . . . . . . . . # . # # . # # # # . . . . . . . . . . . . . . . . . . . . . . . . . . . . . . . # # . # . # # # . . . . . . . . . . . . . . . 
. . . . . . . . . . . . # . . . # . # . . . . . . . . . . . . . . . . . . # # . # # . # . # # . . . # # . . . . . . # # # . . . . . . . . . . . . . . . # # . # # # # # # . . . . . . . . . . . . . . . 
. . . . . . . . . . . . # . . . # . # . . . . . . . . . . . . . . . . . . . # . . . # # # . # # # . . . # # # # # # # . # # # # # # # # # # # # # # # # # . # # # # . # . . . . . . . . . . . . . . . . 
. . . . . . . . . . . . # . . . # . # . . . . . . . . . . . . . . . . . . . # # . . . . # # # # # # # # # # # # # # # # # # # # # # # # # # # # # # # # # # # . . . # # . . . . . . . . . . . . . . . . 
. . . . . . . . . . . . # . . . # . # . . . . . . . . . . . . . . . . . . . . # . . . . . # # # . . . . . . . . . . . . . . . . . . . . . . . . . . . . # # # . # # . . . . . . . . . . . . . . . . . . 
. . . . . . . . . . . . . . . . . . . . . . . . . . . . . . . . . . . . . . # . . . . . . . . # # # # # # # # # # # # # # # # # # # # # # # # # # # # # # # # # # . . . . . . . . . . . . . . . . . . . 
. . . . . . . . . . . . . . . . . . . . . . . . . . . . . . . . . . . . . . # # # # # # # # # # # # . . . . . . . . . . . . . . . . . . . # # # # # # . . . . . . . . . . . . . . . . . . . . . . . . . 
. . . . . . . . . . . . . . . . . . . . . . . . . . . . . . . . . . . . . . . . . . . . . . . . . . # . . . . . . . . . . . . . . . . . . . . . . . . . . . . . . . . . . . . . . . . . . . . . . . . . 
. . . . . . . . . . . . . . . . . . . . . . . . . . . . . . . . . . . . . . . . . . . . . . . . . . . . . . . . . . . . . . . . . . . . . . . . . . . . . . . . . . . . . . . . . . . . . . . . . . . . 
. . . . . . . . . . . . . . . . . . . . . . . . . . . . . . . . . . . . . . . . . . . . . . . . . . . . . . . . . . . . . . . . . . . . . . . . . . . . . . . . . . . . . . . . . . . . . . . . . . . . 
. . . . . . . . . . . . . . . . . . . . . . . . . . . . . . . . . . . . . . . . . . . . . . . . . . . . . . . . . . . . . . . . . . . . . . . . . . . . . . . . . . . . . . . . . . . . . . . . . . . . 
. . . . . . . . . . . . . . . . . . . . . . . . . . . . . . . . . . . . . . . . . . . . . . . . . . . . . . . . . . . . . . . . . . . . . . . . . . . . . . . . . . . . . . . . . . . . . . . . . . . . 
. . . . . . . . . . . . . . . . . . . . . . . . . . . . . . . . . . . . . . . . . . . . . . . . . . . . . . . . . . . . . . . . . . . . . . . . . . . . . . . . . . . . . . . . . . . . . . . . . . . . 
. . . . . . . . . . . . . . . . . . . . . . . . . . . . . . . . . . . . . . . . . . . . . . . . . . . . . . . . . . . . . . . . . . . . . . . . . . . . . . . . . . . . . . . . . . . . . . . . . . . . 
. . . . . . . . . . . . . . . . . . . . . . . . . . . . . . . . . . . . . . . . . . . . . . . . . . . . . . . . . . . . . . . . . . . . . . . . . . . . . . . . . . . . . . . . . . . . . . . . . . . . 
. . . . . . . . . . . . . . . . . . . . . . . . . . . . . . . . . . . . . . . . . . . . . . . . . . . . . . . . . . . . . . . . . . . . . . . . . . . . . . . . . . . . . . . . . . . . . . . . . . . . 
. . . . . . . . . . . . . . . . . . . . . . . . . . . . . . . . . . . . . . . . . . . . . . . . . . . . . . . . . . . . . . . . . . . . . . . . . . . . . . . . . . . . . . . . . . . . . . . . . . . . 
. . . . . . . . . . . . . . . . . . . . . . . . . . . . . . . . . . . . . . . . . . . . . . . . . . . . . . . . . . . . . . . . . . . . . . . . . . . . . . . . . . . . . . . . . . . . . . . . . . . . 
. . . . . . . . . . . . . . . . . . . . . . . . . . . . . . . . . . . . . . . . . . . . . . . . . . . . . . . . . . . . . . . . . . . . . . . . . . . . . . . . . . . . . . . . . . . . . . . . . . . . 
. . . . . . . . . . . . . . . . . . . . . . . . . . . . . . . . . . . . . . . . . . . . . . . . . . . . . . . . . . . . . . . . . . . . . . . . . . . . . . . . . . . . . . . . . . . . . . . . . . . . 
. . . . . . . . . . . . . . . . . . . . . . . . . . . . . . . . . . . . . . . . . . . . . . . . . . . . . . . . . . . . . . . . . . . . . . . . . . . . . . . . . . . . . . . . . . . . . . . . . . . . 
. . . . . . . . . . . . . . . . . . . . . . . . . . . . . . . . . . . . . . . . . . . . . . . . . . . . . . . . . . . . . . . . . . . . . . . . . . . . . . . . . . . . . . . . . . . . . . . . . . . . 
. . . . . . . . . . . . . . . . . . . . . . . . . . . . . . . . . . . . . . . . . . . . . . . . . . . . . . . . . . . . . . . . . . . . . . . . . . . . . . . . . . . . . . . . . . . . . . . . . . . . 
. . . . . . . . . . . . . . . . . . . . . . . . . . . . . . . . . . . . . . . . . . . . . . . . . . . . . . . . . . . . . . . . . . . . . . . . . . . . . . . . . . . . . . . . . . . . . . . . . . . . 
. . . . . . . . . . . . . . . . . . . . . . . . . . . . . . . . . . . . . . . . . . . . . . . . . . . . . . . . . . . . . . . . . . . . . . . . . . . . . . . . . . . . . . . . . . . . . . . . . . . . 
. . . . . . . . . . . . . . . . . . . . . . . . . . . . . . . . . . . . . . . . . . . . . . . . . . . . . . . . . . . . . . . . . . . . . . . . . . . . . . . . . . . . . . . . . . . . . . . . . . . . 
. . . . . . . . . . . . . . . . . . . . . . . . . . . . . . . . . . . . . . . . . . . . . . . . . . . . . . . . . . . . . . . . . . . . . . . . . . . . . . . . . . . . . . . . . . . . . . . . . . . . 
. . . . . . . . . . . . . . . . . . . . . . . . . . . . . . . . . . . . . . . . . . . . . . . . . . . . . . . . . . . . . . . . . . . . . . . . . . . . . . . . . . . . . . . . . . . . . . . . . . . . 
. . . . . . . . . . . . . . . . . . . . . . . . . . . . . . . . . . . . . . . . . . . . . . . . . . . . . . . . . . . . . . . . . . . . . . . . . . . . . . . . . . . . . . . . . . . . . . . . . . . . 
. . . . . . . . . . . . . . . . . . . . . . . . . . . . . . . . . . . . . . . . . . . . . . . . . . . . . . . . . . . . . . . . . . . . . . . . . . . . . . . . . . . . . . . . . . . . . . . . . . . . 
. . . . . . . . . . . . . . . . . . . . . . . . . . . . . . . . . . . . . . . . . . . . . . . . . . . . . . . . . . . . . . . . . . . . . . . . . . . . . . . . . . . . . . . . . . . . . . . . . . . . 
. . . . . . . . . . . . . . . . . . . . . . . . . . . . . . . . . . . . . . . . . . . . . . . . . . . . . . . . . . . . . . . . . . . . . . . . . . . . . . . . . . . . . . . . . . . . . . . . . . . . 
. . . . . . . . . . . . . . . . . . . . . . . . . . . . . . . . . . . . . . . . . . . . . . . . . . . . . . . . . . . . . . . . . . . . . . . . . . . . . . . . . . . . . . . . . . . . . . . . . . . . 
. . . . . . . . . . . . . . . . . . . . . . . . . . . . . . . . . . . . . . . . . . . . . . . . . . . . . . . . . . . . . . . . . . . . . . . . . . . . . . . . . . . . . . . . . . . . . . . . . . . . 
. . . . . . . . . . . . . . . . . . . . . . . . . . . . . . . . . . . . . . . . . . . . . . . . . . . . . . . . . . . . . . . . . . . . . . . . . . . . . . . . . . . . . . . . . . . . . . . . . . . . 
. . . . . . . . . . . . . . . . . . . . . . . . . . . . . . . . . . . . . . . . . . . . . . . . . . . . . . . . . . . . . . . . . . . . . . . . . . . . . . . . . . . . . . . . . . . . . . . . . . . . 
. . . . . . . . . . . . . . . . . . . . . . . . . . . . . . . . . . . . . . . . . . . . . . . . . . . . . . . . . . . . . . . . . . . . . . . . . . . . . . . . . . . . . . . . . . . . . . . . . . . .